Urdu	T	Arabic
میں صحیح ہو یا غلط	T	أنا على حق أو خطأ؟
آپ سے بات کرنا اچھا لگا	T	سعدت بالتحدث معك
اسکی ایک بہن ہے	T	لديه شقيقة
مجھے کیا کہنا چاہیے	T	ماذا يجب أن أقول
کیا یہ غلط ہے	T	هل هذا خطأ؟
کوئی مسئلہ نہیں	T	لا مشكلة
میں نہیں جانتا	T	لا أعلم
کوئی مسئلہ ہے	T	هناك مشكلة
میں اپ سے بعد میں ملتا ہوں	T	أراك لاحقا
خوش آمدید	T	أهلا وسهلا
یہ مہنگا کیوں ہے	T	لماذا هي مكلفة
اور تم	T	وأنتم
تم سمجھتے ہو میں نے کیا کہا؟	T	هل فمهت ما قلته
یہ کیا ہے	T	ما هذا
اس لفظ کا اردو میں کیا مطلب ہے؟	T	ماذا تعني هذه الكلمة بالأوردية
مجھ نہیں پتہ	T	لا أعرف
کیا کوئی مسئلہ ہے	T	هل هناك اي مشكلة
کیا یہ درست ہے	T	هل هذا صحيح
کیا یہ غلط ہے؟	T	هل هذا خطاء
کیا وقت ہوا ہے	T	كم الساعة
غرفة الفصل	T	الغرفة
ماموں	T	عم
خاوند	T	زوج
عمارت کے نیچے ایک دوکان ہے	T	يوجد محل تحت المبنى
دیور پر ایک تصویر ہے	T	هناك صورة على الجدار
لوگ	T	الناس
آپ کہاں ہو؟	T	أين أنت؟
تم کہاں ہو	T	أين أنت
باغ میں بھت لوگ ہیں	T	هناك الكثير من الناس في الحديقة
گلاس میں پانی ہیں	T	يوجد ماء في الزجاج
باغ میں بہت لوگ ہیں	T	هناك الكثير من الناس في الحديقة
گلاس میں پانی ہے	T	يوجد ماء في الزجاج
فرش پر قالین ہے	T	هناك سجادة على الأرض
	T
جیب میں پیسے ہیں	T	هناك أموال في الجيب
ہاتھ میں قلم ہے	T	يوجد قلم في يده
آپ کاروبار کیا ہے	T	ماهو عملك؟
اڈہ	T	قاعدة
ہوائی جہاز	T	طائرة
ہوائی اڈہ	T	مطار
صحت مند غذا	T	الطعام الصحي
دھکیلنا	T	يدفع
بیویاں	T	زوجات
گھڑی	T	الساعة
یہ کیا آینہ ہی	T	ما هذه المرآة؟
جی ہاں! یہ ہاتھ ہے	T	نعم!  هذه هي اليد
کیا یہ ہاتہ ہے	T	هل هذه يد؟
نہیی یہ قالین نہیی ہی	T	ليس هذه السجادة
کیا یہ قالین ہی	T	هل هذه سجادة؟
نہیں یہ چاندا نہیں ہے	T	لا ليس من الفضة
ہی کیا ہو	T	ما أخبارك
پلنگ	T	السرير
آینہ	T	المرآة
آپ کتنی کرتے رہے	T	منذ متى وانت تفعل؟
بچہ	T	طفل
پلے	T	يلعب
وہ تھے	T	كانت
کہڑکی	T	النافذة
لحظہ	T	اللحظة
رسی	T	الحبل
چیونٹی	T	النملة
بلی	T	قطة
شفاخانہ	T	مستشفى
تلوار	T	سيف
یہ نمک ہے	T	هذا ملح
وہ پھول ہے	T	هي زهرة
یہ عینک ہے	T	هذه هي العدسة
چھت	T	السطح
یہ دیوار ہے	T	هذا هو الحائط
یہ گھڑ کی ہے	T	إنها ملفقة
خواہش	T	يرغب
آزاد	T	حر
آٹا	T	دقيق
آگ	T	نار
آپریشن	T	عملية
وزیر	T	وزير
زور	T	توكيد
شور	T	ضوضاء
وطن	T	دولة
ہے	T	يكون
ہیں	T	نكون
کیا میں صحیح ہے	T	هل انا على حق؟
ٹھیک	T	بخير
یہ لڑکا ہے	T	هذا فتى
مہنگا ہے	T	إنه باهظ الثمن
یہ بہت مہنگا ہے	T	أنها مكلفة للغاية
!خوش آمديد	T	!مرحباً
کیا ہو رہا ہے؟	T	ماذا يحدث؟
(آپ کیسے ہیں ؟ (مہذبانہ	T	(كيف  حالك؟ (مهذب
(کیسے ہو تم؟ (دوستانہ	T	(كيف   حالك (ودية
کیا یہ ٹھیک ہے	T	هل الامور على ما يرام
میں صحیح ہو یا غلط	T	أنا على حق أو خطأ؟
آپ سے بات کرنا اچھا لگا	T	سعدت بالتحدث معك
اسکی ایک بہن ہے	T	لديه شقيقة
مجھے کیا کہنا چاہیے	T	ماذا يجب أن أقول
کیا یہ غلط ہے	T	هل هذا خطأ؟
کوئی مسئلہ نہیں	T	لا مشكلة
میں نہیں جانتا	T	لا أعلم
کوئی مسئلہ ہے	T	هناك مشكلة
ریل گاڑی	T	قطار
مجھے	T	أنا
